a	неопределенный артикль
ability	способность, возможность
able	знающий, умелый, способный 
about	кругом, повсюду, приблизительно
about	о, насчет, на тему, касательно
above	наверху, вверху, выше, над
abroad	за границей, за границу
absolutely	совершенно, безусловно
accept	принимать, соглашаться, признавать
acceptable	приемлемый; допустимый
accident	несчастный случай, авария
accidental	случайный
accidentally	случайно, нечаянно
accommodation     	помещение, жилье
according to	в соответствии с, согласно
account	счет, расчет, подсчет
achieve	добиваться, достигать
achievement	достижение, успех 
across	поперек, сквозь, через
act	действовать, поступать
action	действие, поступок
active	активный, деятельный
activity	деятельность
actual	фактический, реальный
actually	фактически, на самом деле
add	прибавлять, присоединять
address	адрес, обращение, речь
address	адресовать, направлять 
adjective	имя прилагательное
admire	любоваться, восхищаться
admit	допускать, соглашаться
advanced	передовой, продвинутый
advantage	преимущество
advice	совет
advise	советовать, советоваться
affect	 (воз)действовать, влиять  
afford	быть в состоянии, предоставлять 
afraid	испуганный
after	за, позади
after	после, потом
afternoon	время после полудня
afterwards	впоследствии, позднее
again	еще, вновь, опять
against	прямо напротив, лицом к
age	возраст
ago	тому назад
agree	соглашаться
agreement	согласие, соглашение
ahead	вперед; впереди
aim	намерение, цель
aim	домогаться, стремиться 
air	воздух, атмосфера
alive	живой
all	весь, вся, все, целый 
allow	позволять, разрешать
almost	почти; едва не
alone	единственный, одинокий, одиноко
along	вдоль, по  
along	в том же направлении 
already	уже
also	тоже, также, к тому же
although	хотя, несмотря на то, что
always	всегда, неизменно
among	между, посреди, среди
amount	величина, количество
and	и, а, но
angry	рассерженный, сердитый, 
announce	объявлять, извещать
another	другой, еще один (такой же) 
answer	ответ
answer	отвечать, откликаться
anxious	озабоченный, беспокойный
any	всякий, какой-нибудь, любой, никакой
any	нисколько, сколько-нибудь, ничуть
anybody 	кто-нибудь, никто, любой
anyone	кто-нибудь, никто, любой
anything	что-нибудь, ничто, ничего
anyway = anyhow	так или иначе, как-нибудь, все равно
anywhere	где-нибудь, куда-нибудь, никуда, везде
apart	в стороне, отдельно, отлично от
apologize = apologise	извиняться, просить прощения 
apparently	очевидно, по-видимому
appeal	призыв, обращение, привлекательность
appeal	обращаться, взывать (to - к)  
appear	показываться, появляться
appearance	внешность, появление
apply	обращаться(с просьбой), применять(ся)
approval	одобрение, утверждение
approve	одобрять (что-л.- of), утверждать
area	площадь, участок, пространство
argue	спорить
argument	довод, аргумент
arm	рука (от кисти до плеча)
around	всюду, кругом, повсюду, вокруг 
arrange	приводить в порядок, расставлять
arrangement	размещение, расположение
arrival	прибытие (at, in; from)
arrive	прибывать
art	искусство
artificial	искусственный, ненатуральный
as	в качестве, как, как например, т.к. 
ashamed	пристыженный
ask	спрашивать, просить
at	в, на, за, при, у, около
attach	прикреплять, прилагать 
attempt	попытка, проба, опыт
attempt	пытаться, стараться, стремиться
attention	внимание, внимательность
attitude	позиция, отношение 
attract	привлекать, притягивать
attractive	заманчивый, привлекательный
authority	власть, полномочие, авторитет
autumn	осень
available	доступный, (при)годный, полезный
average	среднее, средний
avoid	избегать, остерегаться, уклоняться
awake	не спящий, проснувшийся
aware	знающий, осведомленный
away	прочь, вдали
	
	
	
B b	
back	спина, спинка, зад, задняя часть
back	назад, обратно, сзади, позади
back	поддерживать, подкреплять
backwards	назад, обратно
bad	плохой
badly	плохо
bag	сумка
balance	весы, равновесие, баланс
ball	шар, мяч
band	оркестр, лента, полоса
bang	удар, стук
bang	ударять, хлопать
bank	банк, берег
bar	бар, брусок, барьер
base	база, базис, основа, основание
base	базировать, основывать
basic	составляющий основу, основной
basically	в своей основе; по существу
basis	базис, основа, основание
bath	ванна
battery	батарея, аккамулятор
be	быть
bear	терпеть, выносить
beat	бить, колотить
beautiful	красивый
because	потому что, так как
become	становиться
before	перед, до, раньше
before	впереди, вперед, прежде
before	прежде чем, до того как
begin	начинать (ся)
beginning	начало
behave	вести себя, поступать
behaviour	поведение
behind	сзади, позади, после, за
behind	задний
belief	вера, доверие
believe	верить, полагать
belong	принадлежать, соответствовать
below	ниже, внизу, под
bend	сгибать (ся), гнуть (ся)
beneath	под, ниже, внизу
benefit	выгода, прибыль
beside	рядом с, возле, около
best	лучший, наилучший
best	лучше всего, больше всего
bet	пари
bet	держать пари
better	лучший, наилучший
better	лучше
between	между
beyond	за, по ту сторону, за пределами
big	большой
bill	счет
bin	ящик
birth	рождение
birthday	день рождения
bit	кусочек
bite	укус
bite	кусать (ся)
black	черный
black	черный цвет
blame	упрек, осуждение
blame	осуждать
blind	слепой, ослепленный
block	блок, квартал
block	заграждать, блокировать
blow	веять, дуть
blue	голубой, синий
board	доска
boat	лодка, судно
body	тело
boil	варить (ся), кипятить (ся)
book	книга
book	вносить в книгу, регистрировать
border	граница
bored	скучающий
boring	скучный
born	родившийся
borrow	одалживать, занимать
both	оба, обе
bother	беспокоить(ся), надоедать
bottom	дно, низ
bottom	нижний
bound	связанный
brain	мозг, интеллект
branch	ветвь, отрасль
brave	смелый, храбрый
bread	хлеб
break 	перерыв, разрыв
break	ломать, разрушать
break down	разрушать, разбивать на кусочки
break in	вламываться, врываться
break into	вламываться, внезапно начинать
break out	выламывать, вспыхивать
break through	прорваться, пробиться
break up	крошиться на мелкие части
breakfast	завтрак
breath	дыхание, вздох 
breathe	дышать
bridge	мост
brief	короткий, недолгий 
bright	яркий
bring	приносить, привозить
bring back	приносить обратно, возвращать
bring down	свалить, снизить (цену)
bring forward	выдвигать (предложение)
bring up	приводить, приносить наверх
broad	широкий
broken	разбитый, сломанный
brother	брат
brown	коричневый, бурый
brush	щетка
brush	чистить щеткой, причесывать
build	строить
building	здание, сооружение
bunch	связка, пучек
burn	гореть, пылать
burst	лопаться, взрываться
bury	хоронить, закапывать
bus	автобус
bush	куст
business	дело, занятие
busy	занятой, деятельный
but	а, но, однако  
but	кроме, за исключением, исключая
butter	масло
buy	покупать
by	у, при, около, возле, рядом с 
by	близко, возле, около, рядом
bye 	до свидания
	
	
	
	
Cc	
call	тефонный звонок, вызов, крик
call	кричать, называть
call at	останавливаться (где -л.), заходить 
call back	перезванивать кому-л.
call off	отменять, откладывать, переносить
call out	выкрикивать, вызывать
call up	вызывать, звонить (по телефону)
calm	спокойный, мирный
calmly	спокойно, невозмутимо
can	мочь, быть в состоянии
cap	кепка
capital	столица
car	автомобиль, машина
card	карточка
care	забота, уход
care	заботиться (for, of, about)
careful	осторожный, внимательный
careless	беззаботный, небрежный
carry	носить
case	случай, чехол
catch	ловить, поймать
cause	причина, основание 
cause	послужить причиной/поводом для ч-л.
centimetre	сантиметр
central	центральный
centre	центр
century	столетие, век
certain	определенный, уверенный
certainly	конечно, естественно
challenge	(сложная) проблема
chance	возможность, случай
change	перемена, изменение
change	менять (ся), изменять (ся)
character	характер, действующее лицо
characteristic	характерная черта, особенность
charge	плата, цена
charge	назначать, запрашивать цену
chase	гнаться, преследовать
chat	непринужденно болтать, беседовать
cheap	дешевый
cheat	обманывать, надувать
check	контроль, проверка
check	проверять, сверять
cheek	щека
cheque	чек
chief	главный, основной
child	ребенок
children	дети
chin	подбородок
choice	выбор, отбор
choose	выбирать 
church	церковь
cinema	кинотеатр
circle	круг, окружность
circumstance	обстоятельство, случай
city	город
claim	требование, претензия
claim	требовать, предъявлять требования
class	класс, группа
classroom	классная комната, аудитория
clean	чистый
clean	чистить
clear	чистый, ясный
clear	очищать, осветлять
clearly	ясно, очевидно
clever	умный
climb	карапкаться, лазить
close	закрывать (ся)
close	близкий
closed	закрытый, запертый
closely	близко, вплотную
clothes	одежда
club	клуб
clue	ключ (к разгадке), улика
coat	пальто
coffee	кофе
cold	холодный
collect	собирать, коллекционировать 
collection	коллекция
colour	цвет, оттенок
combination	сочетание, комбинация
combine	соединяться, объединять(ся)
come	приходить, подходить 
come back	возвращаться
come down	спускаться, опускаться
come from	приходить откуда-л.
come in	входить
come off	отрываться, отделываться
come out	выходить
come over	приезжать, приходить
come round	заходить ненадолго, заглянуть
come up	подниматься, возникать
comfort	комфорт
comfortable	комфортный, удобный
command	команда, распоряжение
comment	комментарий, замечание
comment	комментировать
commit	совершать (преступление)
common	общее, распространенное
common	общий, всеобщий
communicate	сообщать, передавать
communication	коммуникация, связь
community	сообщество
company	компания
compare	сравнивать, сверять
compete	состязаться, соперничать
complain	жаловаться, выражать недовольство 
complaint	жалоба, недовольство
complete	полный, укомплектованный
complete	завершать, укомплектовывать
completely	вполне, полностью
complicated	запутанный, трудный для понимания
computer	компьютер
concentrate	сосредоточивать (ся)
concentration	концентрация, сосредоточенность
concern	отношение, беспокойство
concerned	заинтересованный, беспокоящийся
concerning	касательно, относительно
conclusion	умозаключение, вывод
condition	условие 
conduct	сопровождать, сопутствовать
confidence	вера, уверенность
confident	уверенный 
confuse	смешивать, спутывать 
confused	смущенный; озадаченный
confusing	сбивающий с толку
congratulate	поздравлять
congratulations	поздравление
connect	соединять (ся), сочетать (ся)
connected	связанный с кем-л., чем-л.
connection	связь, соединение
consider	рассматривать, считать
considering	учитывая, принимая во внимание
consist	состоять, составлять из (of)
constantly	непрерывно, регулярно
consult	советоваться, консультироваться
contact	контакт, соприкосновение
contact	связываться, общаться
contain	содержать, вмещать
container	контейнер, емкость
content	содержимое, содержание
content	довольный
contents	содержимое
continue	продолжать (ся), оставаться
contrast	различие, контраст
contrast	сопоставлять, сравнивать (with)
contribute	способствовать, вносить вклад
control	надзор, контроль
control	управлять, контролировать
convenient	удобный, близкий
conversation	разговор, беседа
convince	убеждать, уверять 
convinced	убежденный, уверенный 
convincing	убедительный
cook	готовить 
cool	прохладный, свежий
cope	справиться, выдержать
copy	копия
copy	копировать
corner	угол
correct	правильный, соответствующий
correct	исправлять, корректировать
correction	исправление, корректирование
cost	цена, стоимость, расходы
cost	стоить
cough	кашлять
could	прош. вр. от can 
count	считать, подсчитывать
country	страна, деревня
couple	пара, два, двое
course	курс, блюдо
cover	крышка, обложка
cover	накрывать, покрывать
crash	грохот, авария, крушение
crash	рушиться, грохотать
crazy	ненормальный, псих
create	создавать, порождать
creature	создание, творение
crime	преступление, нарушение
crisis	кризис
criticism	критика
criticize	критиковать
cross	крест
cross	перекрещивать, пересекать (ся) 
crowd	толпа
crowded	переполненный, битком набитый
cruel	жестокий
cruelty	жестокость
cry	плач
cry	плакать
culture	культура
curious	любопытный, любознательный
custom	обычай, таможня
cut	резать
cut	разрез, порез
	
	
	
	
D d	
damage	вред, повреждение
damage 	повреждать, портить
damp	влажный, сырой
dance	танец
dance	танцевать
danger	опасность
dangerous	опасный
dare	осмеливаться, сметь
dark	темный
date	дата
day	день
dead	мертвый
deaf	глухой
deal	сделка, соглашение
dear	 дорогой, милый
debt	долг
decide	решать (ся), принимать решение
decision	решение
declaration	декларация
declare	заявлять, заявлять
deep	глубокий
deep	глубоко
defeat	одержать победу
defend	защищать (ся)
definite	ясный, точный
degree	степень, градус
deliberate	намеренный, предумышленный  
deliberately	сознательно,обдуманно
delicate	нежный
delight	удовлетворение, удовольствие
deliver	доставлять, разносить
demand	требовать
demonstrate	показывать, демонстрировать
depend	зависеть, находиться в зависимости
describe	описывать
description	описание
deserve	заслуживать
design	проект, намерение, дизайн
design	разрабатывать, проектировать
desperate	безнадежный; бесперспективный
destroy	разрушать, ликвидировать
detail	деталь
determined	решительный
develop	развивать (ся)
development	развитие
die	умереть, скончаться
difference	разница, отличие
different	различный, разный 
difficult	трудный, сложный
difficulty	трудность
dig	копать, рыть
dinner	обед
direct	прямой
direct	руководить, направлять
direction	направление
disagree	не совпадать, противоречить
disappear	исчезать
disappointed	разочарованный
disapprove	осуждать, не одобрять
discover	обнаруживать, открывать
discovery	открытие
discuss	обсуждать
discussion	дискуссия
disgusting	противный
dish	блюдо
display	показ, выставка
distance	расстояние, дистанция
distant	дальний, далекий
disturb	беспокоить, волновать
disturbing	беспокоящий, волнующий
divide	отделять (ся), разъединять (ся)
division	деление, разделение
do	делать
doctor	врач, доктор
door	дверь
doubt	сомнение
doubt	сомневаться
down	вниз, внизу
downstairs	расположенный в нижнем этаже, вниз
draw	рисовать
drawing	рисунок, рисование
dream	сон, мечта
dream	сниться, мечтать
dress	платье, одежда
dress	одевать (ся), наряжать (ся)
drink	напиток, глоток
drink	пить
drive	езда
drive	везти, ездить, управлять (автомобил)
drop	капля, падение
drop	ронять, падать
dry	сухой
dry	сушить (ся), сохнуть
dull	скучный, тупой
during	в течение, во время
duty	обязанность
	
	
	
Ee	
each	каждый, всякий
eager	страстно желающий, жаждущий 
ear	ухо
early	ранний, рано
earn	зарабатывать, заслуживать
earth	Земля, земля
easy	легкий
eat	есть, кушать
edge	кромка, край
education	образование, обучение
effect	результат, следствие
effort	усилие, попытка
either	любой (из двух), один из двух
either	один из двух, такой или другой
else	еще, кроме
embarrassed	смущенный, растерянный
embarrassing	стеснительный, смущающий
emergency	непредвиденный случай
emotion	чувство, эмоция
emphasis	важность, значимость
emphasize	подчеркивать, акцентировать
empty	пустой
encourage	поощрять, поддерживать
end	конец
end	кончать, завершать
enemy	враг
energy	энергия, сила
enjoy	получать удовольствие, наслаждаться
enjoyable	приятный
enough	достаточно, достаточный
enter	входить, поступать
entertainment	развлечение
enthusiastic	восторженный, увлеченный
entrance	вход
entry	вход, проход
environment	окружение, окружающая среда
equal	равный, одинаковый
equal	равняться, соответствовать
equipment	оборудование, оснащение
error	заблуждение, ошибка
escape	убегать, избегать
especially	особенно, в особенности
estimate	оценка
estimate	оценивать, исчислять
even	даже
even	ровный, равномерный
evening	вечер
event	событие
ever	всегда, когда-либо
every	каждый,  любой
everybody	каждый, всякий (человек), все
everyone	каждый, всякий (человек), все
everything	всё 
everywhere	везде, всюду
evidence	доказательство, основание
exact	точный
exactly	точно
exaggerate	преувеличивать
exam	экзамен
example	пример
excellent	отличный
except	исключая, кроме
exchange	обмен
exchange	обменивать
excited	взволнованный, напряженный 
exciting	возбуждающий, волнующий
excuse	извинение
excuse	извиняться, просить прощения
exercise	упражнение, тренировка
exhibition	выставка
exist	существовать, иметься в природе
exit	выход
expect	ожидать, надеяться
expensive	дорогой
experience	(жизненный) опыт, опыт работы
experiment	опыт, эксперимент
explain	объяснять, разъяснять
explanation	пояснение, разъяснение
exploration	исследование, изучение
expression	выражение, выражение (лица)
extra	добавочный, дополнительно
extraordinary	необычный, чрезвычайный
extremely	чрезвычайно, крайне
eye	глаз
	
	
F f	
face	лицо
face	быть обращенным к,  стоять лицом к 
fact	обстоятельство, факт
factory	завод, фабрика
fail	потерпеть неудачу, не сбыться
failure	неспособность, несостоятельность
fair	честный, справедливый, светлый
fairly	должным образом, довольно
fall	падение
fall	падать
false	неверный, ошибочный
familiar	хорошо знакомый, привычный
family	семья
famous	знаменитый, известный
far	далеко
far	дальний, далекий
fashion	мода
fast	быстрый, скорый 
fast	быстро, скоро
fasten	прикреплять, застегивать (ся)
fat	толстый, упитанный
father	отец
fault	недостаток, неисправность
favour	одолжение, услуга
favourite	любимый
fear	боязнь,  страх
fear	бояться 
feature	особенность, характерная черта
feed	кормить
feel	чувствовать, ощущать
feeling	ощущение, чувство
female	самка,  женская особь
female	женского пола, женский
fence	забор
fetch	принести, добиваться
few	мало, немного, несколько
field	поле
fierce	свирепый, лютый
fight	драться, сражаться
figure	цифра, фигура
file	папка, досье
fill	наполнять (ся)
film	фильм
final	завершающий, заключительный
finally	наконец, в конце концов
find	находить
fine	превосходный, тонкий
finger	палец (на руке)
finish	заканчивать, завершать
fire	огонь, пожар
fire	стрелять, выстреливать, увольнять
firm	твердый, стойкий
first	первый, сначала
fit	подходить, соответствовать
fit	подходящий, соответствующий 
fix	ремонтировать, устанавливать
flat	плоский, ровный
flat	ровно, плоско
flavour	вкус, аромат
flight	полет
float	плавать, держаться на  воде 
flood	заливать, затоплять
floor	пол, этаж
flow	течение, поток
flow	течь, струиться
fly	летать
fold	загибать, складывать
follow	следовать, следить
fond	нежный, любящий
food	пища, еда
foot	ступня, подножие
for	для, в течение
force	сила
force	заставлять, принуждать
foreign	иностранный; заграничный
forever	навсегда, всегда
forget	забывать
forgive	прощать 
fork	вилка
form	форма, вид, класс (в школе)
form	образовывать, формировать
formal	официальный, формальный
fortunate	счастливый, удачливый
fortunately	к счастью
forward	вперед, спереди
frame	рама, оправа, каркас
free	свободный, бесплатный
free	освобождать
free	бесплатно
freedom	свобода
freeze	замораживать, замерзать
frequent	частый
fresh	свежий
friend	друг
friendly	дружественный
frighten	пугать
frightened	испуганный
from	от, из, с
front	передняя сторона чего-л
full	полный
fun	шутка, веселье
funny	забавный, смешной
furniture	мебель
further	дальше, дальнейший
future	будущее
future	будущий
	
	
Gg	
game	игра
gap	щель, промежуток
gas	газ
gate	ворота
gather	собирать (ся)
general	главный, основной
generally	обычно, как правило
generous	щедрый, великодушный
gentle	ласковый, нежный
genuine	истинный, реальный
get	получить
get away	уходить
get back	вернуть (ся)
get off	сойти, слезть
get on 	садиться (в машину)
get out	выходить, вылезать
get up	вставать, подниматься
gift	подарок
give	давать, дарить
give away	отдавать, дарить
give back	возвращать, отдавать
give out	раздавать, распределять
give up	оставить, отказаться
glad	довольный, рад
glass	стекло, стакан
go	идти, ходить
go  away	уходить, уезжать
go back (to)	возвращаться
go down	опускаться, садиться
go off	выстреливать (об оружии), взрываться
go on	продолжать, случаться
go out	выйти, выходить
go up	подниматься, идти вверх
good	хороший
goodbye	до свидания!
government	правительство
grade	степень, класс, сорт
gradually	постепенно
grand	большой, замечательный
grateful	благодарный, признательный
great	большой, огромный
greeting	приветствие
ground	земля
group	группа
grow	расти, вырастать
guard	охрана, защита
guess	предположение, догадка
guess	догадаться, полагать
guide	вести, руководить
guilty 	виновный, виноватый
	
	
	
H h	
habit	обычай, привычка
hair	волосы
half	половина
hand	рука (кисть), стрелка (часов)
handle	управлять, регулировать, трогать
hang	вешать, висеть
happen	случаться, происходить 
happy	счастливый, довольный
hard	жесткий, твердый
hard	активно, упорно
hardly	вряд ли, почти не, едва
harm	вред; зло
hate	ненавидеть
he	он
have	иметь
head	голова
health	здоровье
healthy	здоровый
hear 	слышать, услышать
heart	сердце
heat	жара, тепло
heavy	тяжелый
height	высота, рост
hello	привет!
help	помогать
her	ее
here	здесь
hers	ее
herself	сама, себя
hide	прятать (ся), скрывать (ся)
high	высокий
high	высоко
him	ему, его
himself	сам, себя
his	его
history	история
hit	хит, попдание
hit	ударять, попаать
hold	захвт, рукоятка
hold	дерать
hold on	подождать
hold out	протягивать, предлагать
hold up	останавливать, грабить
hole	дыра
holiday	праздник, отпуск
hollow	пустой, впалый
home	дом
home	дома
honest	честный
hope	надежда
hope	надеяться
hospital	больница
hot	горячий, острый
hour	час
house	дом
how	как
however	однако, тем не менее
human	людской, человеческий
hungry	голодный
hurry	суета, спешка
hurry	торопить (ся), подгонять
hurt	ранить, обижать
hurt	раненый
	
	
I i	
I	я
idea	идея
identify	опознавать, идентифицировать
if	если
ignore	игнорировать, пренебрегать
ill	больной
illness	болезнь
image	образ, имидж
imagination	воображение; фантазия
imagine	воображать, представлять себе
immediate	немедленный
immediately	немедленно, сразу
impatient	нетерпеливый
importance	важность, значимость
important	важный
impossible	невозможный, невыполнимый
impressed	пораженный
impression	впечатление
impressive	впечатляющий, выразительный
improve	улучшать (ся), совершенствовать (ся)
improvement	улучшение, усовершенствование
in	в, во
in	внутри, внутренний
include	заключать, включать в себя
increase	возрастание, рост
increase	возрастать, увеличивать (ся)
indeed	в самом деле, действительно
independent	независимый, самостоятельный
influence	влияние, действие
influence	влиять, воздействовать
inform	сообщать, информировать
information	информация
injury	вред, рана
innocent	невинный, непорочный
inquire	осведомляться, узнавать
inside	внутренний, внутри
insist	настаивать, утверждать
instant	мгновенный, растворимый
instead	вместо, взамен
instruction	инструкция, правило
instrument	инструмент, прибор
intelligent	сообразительный, понятливый
intend	планировать, предназначаться
interest	интерес
interested	заинтересованный, интересующийся
interesting	интересный
interfere	вмешиваться, повлиять
interrupt	прерывать, прекращать
interruption	перерыв, пауза
interview	беседа, интервью
interview	интервьюировать
into	в (о), на
introduce	знакомить, представлять 
introduction	введение, представление
invitation	приглашение
invite	приглашать, звать
involve	вовлекать, вмешивать
issue	вопрос (проблема), выпуск
it	это, он, она, оно
its	его, ее 
Itself	себя, сам, сама, само
	
	
J j	
 job	 работа
join	соединять, объединять
joke	шутка
joke	шутить
journey	путешествие, поездка 
judge	судья
judge	судить, выносить приговор
juice	сок
jump	прыгать
just	только что, точно, только
justice	справедливость, правосудие
	
	
	
K k	
keen	острый, сильный, резкий
keep	держать, хранить
keep away	держать (ся) в отдалении, избегать
keep from	удерживать (ся), воздерживаться 
keep off	не подпускать, воздерживаться
keep out	не допускать, не впускать
keep up	поддерживать, продолжать
key	ключ
kick	ударять ногой, пинать
kill	убивать
kind	сорт, вид
kind	добрый
knock	ударять, стучать
know	знать
knowledge	знание
	
	
L l	
label	ярлык, этикетка
land	земля, суша, почва
land	приземляться, высаживать (на берег)
language	язык
large	большой, крупный
last	последний, прошлый
last	длиться, сохраняться
late	поздний, последний, поздно
later	более поздний
later	позже
laugh	смех
laugh	смеяться, рассмеяться
law	закон
lay	класть, положить 
lead	преимущество, поводок (для собаки)
lead	вести, сопровождать, управлять
lean	наклонять (ся), опирать (ся)
learn	учиться, учить (что-л.)
least	наименьший, наименее
leave	покидать, оставлять
left	левый
left	налево, слева  
left	левая сторона
leg	нога (от бедра до ступни), ножка
legal	легальный, законный
lend	одалживать, давать взаймы
length	длина, расстояние
less	меньше, менее
lesson	урок
let	позволять, разрешать, сдавать внаем
letter	письмо, буква
level	уровень, степень
level	плоский, ровный
lie	лежать
life	жизнь
lift	поднимать (ся)
light	свет, лампа
light	светлый, легкий
light	загораться, освещать
like	любить, нравиться
like	подобный, похожий
likely	вероятный, возможный
limit	граница, предел
limit	ограничивать, ставить предел 
line	линия, очередь, веревка
list	список, перечень
listen	слушать
listen for	прислушиваться
little	маленький
little	мало, немного
live	жить
live	живой
load	груз
load	грузить, загружаться
loan	заем, ссуда
lock	замок, локон
lock	запирать ключом, блокировать
lonely	одинокий
long	длинный
long	долго, длительно
look	смотреть, следить
look after	присматривать, ухаживать за 
look around	осматривать
look back (on)	оглядываться
look up	искать (что-л. в справочнике)
loose	свободный, неупакованный
lose	терять, проигрывать
loss	потеря, гибель
lost	разрушенный, потерянный
lot	много
loud	громкий, шумный
love	любовь
love	любить
low	низкий
lower	нижний, низший
luck	везение, удача, успех
lucky	счастливый, удачный
lunch	обед, ленч
	
	
	
M m	
machine	машина, механизм
mad	сумасшедший, ненормальный
mail	почта
main	главный, основной
mainly	главным образом, преимущественно
maintain	поддерживать, удерживать
major	более важный, больший
majority	большинство
make	делать, создавать
make into	переделывать, превращать во (что-л.)
make up	выдумывать
male	самец
male	мужской, мужского пола
man	человек, мужчина
manage	руководить, управлять
manner	манера, способ, метод
many	много
march	маршировать, вышагивать (нервно)
mark	знак, пятно, оценка
mark	отмечать, обозначать
market	рынок
married	женатый, замужняя
marry	жениться  или выходить замуж
mass	масса, множество
match	спичка, матч
match	подходить, соответствовать
material	материал
matter	дело, вопрос, причина
matter	иметь значение, значить
maximum	максимальный
may	мочь (разрешение)
maybe	может быть
me	меня, мне
meal	прием пищи, еда
mean	неприятный, противный
mean	иметь в виду, значить, думать
meaning	значение, смысл
means	средство, способ, метод
meanwhile	тем временем, между тем
measure	мера, мероприятие
measure	измерять, иметь размер
medium	средний, промежуточный
meet	встречать (ся), знакомиться
meeting	встреча, собрание
memory	память
mend	чинить, ремонтировать
mention	упоминать
mess	беспорядок, неприятность
mess	производить беспорядок
message	сообщение, основная тема 
method	метод, способ
middle	середина
middle	средний, центральный
might	мочь (прош. вр. от may) 
mind	возражать, иметь что-л. против
mind	ум, мнение, воспоминание
mine	мой, моя, мое
mine	шахта, мина
minimum	минимум, минимальное количество
minimum	минимальный  
minor	незначительный, несущественный
minority	меньшинство
minute	минута
miss	скучать, пропустить, не попасть
miss	промах, неудача, отсутствие
mistake	ошибка
mistake	ошибаться
mix	смешивать (ся), соединять
mixture	смешивание, смесь
model	модель, макет
modern	современный
moment	момент, мгновение
money	деньги
month	месяц
mood	настроение
moon	луна
moral	моральный, нравственный
more	больше, еще
morning	утро
most	больше  всего, почти все
mother	мама
motion	движение
mouth	рот
move	движение, развитие
move	двигать (ся), переезжать
movement	движение, передвижение
much	много, очень
murder	убийство
murder	убивать
muscle	мускул, мышца
music	музыка
must	должен, обязан
my	мой, моя, мое
myself	себя, себе, сам
mysterious	таинственный, загадочный 
mystery	тайна, загадка
	
	
	
N n	
name	имя
name	называть, назначать
narrow	узкий
national	национальный, народный  
natural	естественный, природный
naturally	естественно
nature	природа
near	близко, около, возле, рядом
near	ближний, близкий
nearly	почти
neat	аккуратный
necessary	необходимый, нужный
neck	шея, воротник, горлышко
need	нуждаться, требоваться
needle	игла
negative	отрицательный, негативный
neither	ни тот ни другой, ни один из двух
neither	также не
nerve	нерв, мускул
nervous	нервный
never	никогда 
new	новый
news	известие, новость
next	следующий, потом, рядом
nice	хороший, приятный
night	ночь
no	не, нисколько не
no	никакой, нет
noise	шум, грохот
noisy	шумный, неспокойный
none	никакой, ни один, никто
nonsense	абсурд, ерунда
no one	никто
nor	и... не, также... не 
normal	нормальный, обыкновенный
nose	нос
not	не, нет, ни
note	записка, нота
nothing	ничего, ничто
notice	объявление, афиша
now	сейчас
now	теперь
nowhere	нигде, никуда
number	число, номер, количество
nurse	медицинская сестра
	
	
	
O o	
object	предмет, объект, цель
object	возражать, протестовать
objection                                  	возражение, протест
obtain	получать, добывать
obvious	очевидный, ясный
occasion	случай, повод
occasional	случайный
occur	происходить, случаться
ocean	океан
odd	странный, необычный
of	от, об, о, из
off	с, со, от, выключенный
off	несвежий, маловероятный
offence	нарушение, преступление
offend	обижать, раздражать
offer	предложение
offer	предлагать
office	офис
official	официальный
official	должностное лицо
often	часто
oil	нефть, масло
OK or okay	хорошо, правильно
old	старый
on	на, в, по  
on	включенный, действующий
once	один раз, раз
once	однажды, когда-то
one	один
only	только, исключительно
only	единственный
onto	на, в
open	открытый
open	открывать (ся), раскрывать (ся)
operate	действовать, функционировать
operation	операция, деятельность
opinion	мнение
opponent	противник, оппонент 
opportunity	благоприятная возможность
opposite	противоположный
opposite	напротив, против
or	или
order	порядок, заказ в ресторане
order	заказывать, приказывать
ordinary	обычный, обыкновенный
organization	организация
organize	организовывать, планировать
original	начальный, оригинальный
other	другой
otherwise	иначе, во всем остальном
ought	выражает долженствование
our	наш
ours	наш
ourselves	сами, себя
out	вне, снаружи, из, наружу, внешний 
outside	снаружи, вне, за пределами
over	над, выше, через, по
over	свыше, повсюду
owe	быть должным, быть обязанным
own	свой, собственный
	
	
	
P p	
pain	боль, страдание
pair	пара
paper	бумага
part	доля, часть
part	расставаться, разделяться
partner	партнер, супруг (а)
party	вечеринка, партия
pass	проходить, проезжать, передавать
passage	проход, коридор, пассаж
passenger	пассажир
past	прошлое, прошедшее
past	прошлый, прошедший
past	мимо
path	тропинка, дорожка
patience	терпение
patient	терпеливый
pattern	модель, система
pause	пауза
pause	останавливаться
pay	плата, заработная плата
pay	платить
payment	платеж, оплата
peace	мир
peaceful	мирный, миролюбивый
pen	ручка
pencil	карандаш
people	люди
perfect	совершенный
perform	выполнять, выступать 
performance	выступление, выполнение
perhaps	может быть, возможно
period	период
permission	позволение, разрешение
person	человек, личность
personal	личный
persuade	убеждать
petrol	бензин
phone	телефон
phone	звонить по телефону
physical	физический, материальный
pick	выбирать, срывать (плоды), ковырять
picture	картина, рисунок
piece	кусок, часть
pile	куча, кипа
pin	кнопка, гвоздь
pinch	щипать, красть 
pipe	труба, трубопровод
pity	жалость
place	пространство, место, площадь
plain	чистый, одноцветный, понятный
plan	план
plan	планировать
plant	растение, завод
plastic	пластик, пластмасса
plate	тарелка
platform	платформа, трибуна
play	пьеса, игра
play	играть
pleasant	приятный, радостный
please	пожалуйста!
please	радовать, угождать
pleased	довольный
pleasure	удовольствие
plenty	множество, избыток
plenty	вполне, довольно  
pocket	каман
point	точка, цель, место
point	указывать, показывать
poison	яд
police	полиция
polite	вежливый
politics	политика
pollution	загрязнение
pool	бассейн, лужа
poor	бедный
popular	популярный
port	порт
position	положение, место
positive	уверенный, позитивный
possession	владение, обладание
possibility	вероятность, возможность 
possible	вероятный, возможный
possibly	возможно, может быть
post	почта
post	посылать по почте
pot	горшок, банка
pour	лить, наливать
power	сила
powerful	сильный, крепкий
practical	практический, практичный
practice	практика
practise	практиковать (ся), тренироваться
praise	хвалить
precise	точный, определенный
prefer	предпочитать
preparation	подготовка, приготовление
prepare	готовить, подготавливать
present	подарок
present	преподносить, дарить (with)
present	присутствующий, настоящий
press	пресса
press	нажимать, сжимать
pressure	давление, воздействие
pretend	притворяться
pretty	хорошенький, симпатичный
pretty	достаточно, довольно
prevent	предотвращать, мешать
previous	предыдущий, предшествующий 
price	цена
pride	гордость
principle	принцип
print	печатать
priority	преимущество, приоритет
private	частный
prize	приз, премия
probably	вероятно, наверное
problem	проблема
process	процесс
produce	производить, создавать
production	изготовление, продукция
professional	профессиональный
profit	прибыль
programme	программа
progress	прогресс
project	проект
promise	обещание
promise	обещать
pronounce	произносить, заявлять
pronunciation	произношение
proof	подтверждение, доказательство
proper	присущий, правильный
properly	должным образом, надлежаще
protect	защищать, охранять
protection	защита, охрана
protest	протест, несогласие
protest	протестовать, возражать
proud	гордый
prove	доказывать, оказываться
provide	снабжать, обеспечивать
public	общественный, государственный
public	публика, общественность
pull	тянуть, дергать
pump	качать, выкачивать
punish	наказывать, штрафовать
punishment	кара, наказание
pupil	ученик
pure	чистый, беспримесный
purpose	цель, намерение
push	толкать (ся)
put	класть, положить
	
	
	
Q q	
quality	качество
quantity	количество
quarter	четверть, четвертая часть
question	вопрос
question	расспрашивать, допрашивать
quick	быстрый, скорый
quickly	быстро
quiet	тихий, бесшумный
quite	совершенно, вполне, совсем
	
	
	
R r	
race	гонка, раса
radio	радио
rain	дождь
rain	идти, литься (о дожде)
raise	поднимать, собирать
range	ряд, линия
rank	звание, чин
rare	редкий, нечастый
rarely	нечасто, редко
rate	показатель, степень, темп
rather	достаточно, весьма
raw	сырой, необработанный
reach	добираться до, протягивать
react	реагировать, отзываться
reaction	реакция
read	читать
ready	готовый
real	реальный
realize	понимать, осознавать
really	действительно, в самом деле
reason	причина, смысл
reasonable	разумный, благоразумный
receive	получать
recent	недавний, последний
recently	недавно
recognize	признавать, узнавать
recommend	рекомендовать
record	запись, рекорд
record	записывать
recover	выздоравливать, восстанавливать(ся)
recovery	выздоровление, восстановление
reduce	понижать, сокращать
reduction	сокращение, понижение
refer	упоминать
refuse	отказать (ся), отклонять
regard	внимание, уважение
region	область, регион
regional	бластной, районный, региональный
regret	сожалеть
regular	регулярный, правильный
regularly	регулярно
reject	отклонять, отказывать (ся)
related	связанный, родственный
relation	связь, родственник
relationship	родство, взаимоотношение
relative	родственник; родственница
relax	расслабляться, отдыхать
release	освобождать (ся),  отпускать
reliable	надежный, верный
relief	облегчение
rely	полагаться, зависеть
remain	оставаться, находиться
remark	замечание, высказывание
remember	помнить, вспоминать
remove	перемещать, снимать
rent	брать в аренду, сдавать в аренду
repair	ремонтировать, чинить
repeat	повторять
replace	заменять, замещать
reply	отвечать, отзываться
reply	ответ, отклик
report	доклад, отчет
report	сообщать, докладывать
represent	представлять, изображать
rescue	спасать
reserve	резервировать, сберегать
respect	уважение
respect	уважать
responsibility	ответственность 
responsible	ответственный
rest	остаток, отдых
rest	отдыхать, опираться 
result	результат
return	возвращаться
rich	богатый
rid	освобождать, избавлять
ride	ехать
right	право, правда
right	правый, правильный
right	правильно
ring	кольцо, круг
ring	звонить, звенеть
rise	подниматься
risk	риск
risk	рисковать 
road	дорога
rob	грабить, воровать
roll	катить (ся),  вращаться
roof	крыша
room	комната
rough	грубый
round	круглый
round	вокруг, кругом
row	ряд, линия
rub	тереть (ся) 
rubbish	мусор, ерунда
rule	правило
run	бег
run	бежать
run away	убежать
run into	наталкиваться, сталкиваться
. run out 	кончаться
run over	переехать, задавить
rush	спешка, суета
rush	мчаться, торопить
	
	
	
	
	
	
S s	
sad	грустный, печальный
safe	безопасный
safety	безопасность, сохранность
sail	плавать, совершать плавание
sale	продажа, распродажа
same	тот (же) самый, одинаковый
satisfactory	удовлетворительный, достаточный
satisfied	удовлетворенный, довольный
save	спасать, охранять
say	сказать, говорить
scale	вес, шкала, масштаб
scare	пугать
scared	испуганный
scene	сцена, пейзаж
schedule	список, перечень
scheme	проект, план
school	школа
science	наука
score	счет
score	выигрывать
scrap	клочок, кусочек
scrape	скоблить, обдирать, царапать
scream	кричать, вопить
scream	крик
sea	море
search	поиск, розыск
search	искать, разыскивать
season	сезон, время года
seat	сиденье, место
second	второй
second	секнда
secret	секрет, тайна
secret	секретный, тайный
section	секция
see	видеть
seem	казаться
sell	продавать
send	посылать, отправлять
sense	чувство, смысл
sensible	благоразумный, здравомыслящий
sensitive	чувствительный, впечатлительный
sentence	предложение, приговор
separate	отдельный
separate	разделять, расставаться
serious	серьезный, важный 
seriously	серьезно, обоснованно
serve	подавать, обслуживать, служить
service	служба, сервис
set	набор, комплект
set	ставить, класть, устанавливать
settle	улаживать,поселить(ся), устроить(ся)
several	несколько
shade	тень, полумрак
shadow	тень
shake	трясти (сь), встряхивать
shall	следует
shallow	 мелкий, мелководный
shame	стыд
shape	форма, очертание
share	делить (ся), разделять
share	доля, часть
sharp	острый, резкий
she	она
shelter	приют, убежище
shine	сиять, светить (ся), блестеть
shock	удар, толчок, шок
shock	потрясать, шокировать
shoot	стрелять
shop	магазин
shop	делать покупки
shopping	посещение магазина
short	короткий, низкий
should	выражает долженствование
shoulder	плечо
shout	крик
shout	кричать
show	показывать, демонстрировать
show	шоу, показ
shrink	уменьшать (ся), сокращать (ся)
shut	закрывать (ся)
shut	закрытый
sick	больной
side	сторона
side	боковой
sight	вид, зрение, достопримечательность
sign	знак; символ
sign	подписывать (ся)
silent	молчаливый, тихий
similar	подобный, похожий
simple	простой, легкий
since	с тех пор
sing	петь
single	единственный, отдельный
sink	тонуть, погружаться, опускаться
sink	раковина
sister	сестра
sit	сидеть, садиться
situation	положение, ситуация
size	размер
skill	умение, навык
skin	кожа, кожура
skirt	юбка
sky	небеса, небо
sleep	спать
sleep	сон
slice	ломтик
slice	нарезать ломтиками
slide	скользить, засовывать
slight	легкий, незначительный
slightly	незначительно, несущественно
slip	поскользнуться
slow	медленный
slowly	медленно
small	маленький
smart	нарядный, шикарный
smell	пахнуть, нюхать
smell	запах, обоняние
smile	улыбаться
smile	улыбка
smoke	дым
smooth	гладкий, ровный
snow	снег
snow	идти (о снеге)
so	итак, это, так
so	так, таким образом, также
soak	впитывать (ся)
soft	мягкий, нежный
software	компьютерные программы
soil	грунт, почва
solve	решать, разрешать
some	какой-либо, какой-нибудь, несколько
somebody	кто-нибудь, кто-то
somehow	так или иначе, как-нибудь
someone	кто-нибудь, кто-то
something	кое-что, что-нибудь, что-то
sometimes	иногда
somewhere	где-то, где-нибудь, куда-нибудь
song	песня
soon	скоро, вскоре
sore	боль
sorry	огорченный, сожалеющий
sort	вид, сорт, тип
sort	сортировать, классифицировать
sound	звук
sound	звучать
space	пространство, космос
spare	запасной, лишний
speak	говорить, разговаривать
special	особый, специальный
speech	речь
speed	скорость
spend	тратить, проводить
spill	проливать (ся), рассыпать (ся)
spin	крутить (ся), вертеть (ся)
spite	злость
splash	брызгать (ся), плескать (ся)
split	раскалывать (ся), разделять (ся)
spoil	портить (ся),  баловать
sport	спорт
spot	место, пятно
spray	брызгать, распылять
spread	распространять (ся), простираться
spring	весна
spring	отскочить, распрямиться
square	квадрат, площадь
square	квадратный
squash	раздавливать, сжимать 
squeeze	выжимать (ся), выдавливать
stage	ступень, сцена
stamp	марка, штамп
stamp	топать ногой, штамповать
stand	стоять
standard	стандарт
star	звезда
stare	вглядываться, уставиться
start	начало
start	начинать
state	состояние, государство
statement	заявление, утверждение
stay	оставаться, останавливаться
steady	устойчивый, постоянный
steal	воровать, красть
steam	пар
steep	крутой
steer	направлять, управлять
step	шаг, след
stick	приклеивать (ся), втыкать
sticky	клейкий, липкий
stiff	жесткий, плотный
still	до сих пор, все еще, по-прежнему
still	тихий, неподвижный
sting	жалить
stir	размешивать, шевелить (ся)
stone	камень
stop	остановка
stop	останавливать (ся)
store	магазин, склад, запас
store	запасать, хранить
storm	шторм, гроза
story	рассказ, история
straight	прямой
straight	прямо
strange	странный, незнакомый
stranger	незнакомец
street	улица
strength	сила, прочность
stretch	тянуть (ся), растягивать (ся)
strict	строгий
strike	ударять (ся)
strike	забастовка
string	веревка, шнурок
strong	сильный
study	изучать, заниматься
study	изучение, исследование, кабинет
stupid	глупый, тупой
style	стиль
subject	предмет, тема
substance	вещество, субстанция
succeed	удаваться
success	успех, достижение
successful	удачный, успешный
such	такой
sudden	внезапный, неожиданный
suddenly	вдруг, внезапно
suffer	страдать
suggest	предлагать, советовать
suggestion	предложение, совет
suit	костюм
suit	подходить
summer	лето
supply	поставка, предложение
support	поддерживать
suppose	допускать, полагать
sure	уверенный
sure	конечно, безусловно
surface	поверхность
surprise	сюрприз, удивление
surprised	удивленный
surprising	неожиданный, внезапный
survive	пережить, выжить
swallow	глотать
sweep	мести, выметать
sweet	сладкий
swim	плавать
swimming	плавание
swing	качать (ся)
switch	выключатель
switch	переключать
system	система
	
	
	
T t	
table	стол
take	брать
take away	убирать, отнимать
take back	отдавать, возвращать
take off	снимать одежду, взлетать
take out	вынимать, брать с собой
take over	принимать дела от другого
talk	разговор, беседа
talk	разговаривать, болтать
talk back	спорить, возражать
talk into	уговорить, убедить
talk out of	отговорить, разубедить
tall	высокий
tap	(по) стучать, (по) хлопать
tap	кран
tape	 (магнитная) лента
target	цель, мишень
task	задание, задача
taste	вкус
taste	пробовать (на вкус)
tax	налог, пошлина, сбор
teach	преподавать, обучать
team	команда
tear	рвать (ся), отрывать (ся) 
telephone	телефон
television	телевизор
tell	говорить, рассказывать
temper	характер, настроение
temperature	температура
tend	иметь тенденцию, стремиться
tense	возбужденный, напряженный
term	срок, семестр
terrible	страшный, ужасный
test	тест, проверка
test	испытывать, тестировать
than	чем
thank	благодарить
thanks	спасибо
thank you	спасибо
that	тот, та, то, те
that	так, до такой степени
the	определенный артикль
their	их
theirs	их
them	им, их
themselves	себя, себе, сами
. then	затем, потом
there	там, туда
there	есть, имеются
they	они
thick	толстый, густой
thin	тонкий, редкий
thing	вещь, предмет
think	думать, полагать
think of	подумать, предполагать
think over	обдумывать
think through	продумывать
thirsty	испытывающий жажду
this	этот, эта, это
this	данный
thorough	тщательный, исчерпывающий
though	хотя, однако
thought	мысль, размышление
threaten	угрожать
through	через, сквозь, насквозь
through	свободный
throughout	по всему,  повсюду; все время
throw	бросать, кидать
thumb	большой палец (руки)
ticket	билет
tidy	аккуратный, опрятный
tidy	убирать, приводить в порядок
tie	связывать, привязывать
tight	тесный, тугой
time	время
tip	кончик, чаевые
tip	наклонять (ся), опрокидывать
tired	усталый
to	приинфинитивная частица
to	к, в, на, до
today	сегодня, в наши дни
together	вместе
tomorrow	завтра
tone	тон, звук
tongue	язык
tonight	сегодня вечером
too	слишком, тоже
tool	 (рабочий) инструмент
tooth	зуб
top	верхушка, верх, крышка
top	верхний, основной
total	абсолютный, весь, всеобщий
total	целое, сумма, итог
touch	прикосновение, касание
touch	прикасаться, трогать
tough	жесткий, трудный, выносливый
tour	путешествие, экскурсия
towards	по направлению к, по отношению к
town	город
track	тропинка, трек
trade	торговля
trade	торговать
tradition	традиция
traffic	движение, транспорт
tragedy	несчастье, трагедия
train	поезд
train	тренировать (ся), обучать (ся)
translate	переводить
transparent	прозрачный, просвечивающий
transport	перевозка, транспорт
trap	капкан, ловушка, обман
trap	задерживать, останавливать
travel	путешествовать
tread	наступать, топтать
treat	обращаться, относиться, лечить
treat	радость, удовольствие
treatment	лечение,обращение 
trial	судебный процесс, суд
trick	обман, хитрость
trick	обманывать, надувать
trip	путешествие, поездка
trip	спотыкаться, ставить подножку
trouble	беспокойство, неприятность
trousers	брюки, штаны
true	верный, правильный
trust	верить, доверять (ся)
trust	вера, доверие
truth	правда
try	пытаться, стараться
tune	мелодия
turn	очередь, поворот
turn	поворачивать (ся)
turn away	прогонять, не пускать
turn back	обернуться, возвращаться
turn down	убавить, отказывать
turn into	превращать во (что-л.)
turn off	сворачивать, выключать
turn on	включать
turn out	оказаться, выключать
turn over	переворачивать (ся), переключить
turn up	усиливать, увеличивать, находить
twist	крутить, сплетать (ся), обхватывать
type	тип, класс, род
typical	типичный
	
	
	
U u	
unable	неспособный
uncertain	неопределенный, неуверенный
uncomfortable	неудобный
under	вниз, ниже, под
under	при, под
underneath	вниз, внизу, ниже
underneath	вниз, внизу, ниже, под
understand	понимать
undo	развязывать, расстегивать
unfair	несправедливый
unfortunate	неудачливый, несчастливый
unhappy	несчастливый, несчастный
uniform	форма, форменная одежда
union	объединение, союз
unit	часть, единица измерения
unite	соединять (ся), объединять (ся)
university	университет
unkind	злой, недобрый
unless	если не, пока не
unlikely	маловероятный, невероятно
unlucky	несчастливый, неудачный
unpleasant	неприятный, противный
until	до, (до тех пор) пока (не)
unusual	необычный, редкий
up	вверх, наверх, наверху, на
upon = on	на
upset	расстроенный, огорченный
upstairs	вверх, наверху, в верхнем этаже
upwards	снизу – вверх, наверх
urgent	срочный, неотложный
us	нас
use	употребление, использование
use	использовать, пользоваться
used	подержанный, использованный
usual	обыкновенный, обычный
usually	обычно
	
	
	
Vv	
valuable	ценный, полезный
value	ценность, стоимость
vanish	исчезать, пропадать
variety	разновидность, разнообразие
various	различный, разнообразный
very	очень
view	точка зрения, мнение, пейзаж
violence	жестокость, насилие
violent	насильственный
vision	зрение, представление
visit	навещать, посещать
visit	посещение, визит
voice	голос
vote	голосование
	
	
	
 W w	
wait	ждать
wake	просыпаться, будить
walk	прогулка 
walk	гулять, идти (пешком)
wall	стена
wander	бродить, блуждать
want	хотеть
war	война
warm	теплый
warn	предупреждать, предостерегать
warning	предупреждение, предостережение
wash	мыть (ся), стирать
wash	мытье, мойка, стирка
waste	тратить
waste	излишняя трата, отбросы
watch	наблюдать, смотреть
watch	часы (наручные), наблюдение
water	вода
wave	махать, колыхаться
wave	волна, взмах
way	дорога, путь, направление
we	мы
weak	слабый
wealth	богатство
wear	носить (одежду)
weather	погода
week	неделя
weekend	выходные дни, уикэнд
weigh	весить, взвешивать (ся)
welcome	желанный, долгожданный, приятный
welcome	приветствовать
well	хорошо
well	здоровый
wet	мокрый
what	что
whatever	все что, что бы ни
wheel	колесо
when	когда
whenever	всякий раз когда,  когда бы ни
where	где, куда, откуда
wherever	где бы ни, куда бы ни
whether	ли, или
which	который, какой
whichever	какой угодно, какой бы ни
while	пока,  в то время как,  хотя
whisper	шептать
whistle	свистеть
whistle	свисток
who	кто
whoever	кто бы ни,  который бы ни,  любой
whole	весь, целый,  в целом
whom	кого, кому
why	почему
wide	широкий
wide	широко
wild	дикий
will	завещание
will	выражает обещание, намерение
willing	готовый (сделать что-л.)
win	победить, выиграть
wind	ветер
wind	виться, изгибаться, заводить
window	окно
wing	крыло
winter	зима
wipe	вытирать, стирать
wire	проволока, провод
wise	мудрый, благоразумный
wish	желание
wish	желать, хотеть
with	с
within	внутри, в пределах
without	без
woman	женщина
wonder	удивляться, интересоваться
word	слово
work	работа
work	работать, производить
work on	продолжать работать 
work out	решать, разрабатывать
work up to	отрабатывать
world	мир
worried	озабоченный
worry 	беспокоить (ся)
worse	худший
worst	наихудший
worth	стоящий
worth	цена, стоимость
would	выражает желание
wrap	заворачивать,  завертывать
write	писать
wrong	неправильный, неверно
	
	
	
	
 Y y	
year	год
yes	да
yesterday	вчера
yet	еще, уже
you	ты, вы
young	молодой, юный
your	ваш, твой
yours	ваш, твой
yourself	себя, себе, сам
	
	
	
	
Z z	
zero	ноль
